B-B-B-B-B-R-R-R-R-R
B-B-B-B-B-R-R-R-R-R
B-B-B-B-B-R-R-R-R-R
B-B-B-B-B-R-R-R-R-R
B-B-B-B-B-R-R-R-R-R
B-B-B-B-B-R-R-R-R-R
B-B-B-B-B-R-R-R-R-R
B-B-B-B-B-R-R-R-R-R
B-B-B-B-B-B-B-B-B-B
B-B-B-B-B-B-B-B-B-B
Y-Y-Y-Y-Y-Y-Y-Y-Y-Y
Y-Y-Y-Y-Y-Y-Y-Y-Y-Y