G-G-G-_-Y-Y-Y-_-R-_
O-O-O-O-O-O-O-O-O-O
R-R-R-G-G-R-R-G-G-Y
G-G-G-G-R-R-R-R-Y-Y
O-O-O-O-O-O-O-O-O-O
O-O-O-O-O-O-O-O-O-O
R-R-R-R-R-G-G-G-G-G
R-R-R-R-R-G-G-G-G-G
R-R-R-R-R-G-G-G-G-G
R-R-R-R-R-R-R-R-R-R
R-R-R-R-R-R-R-R-R-R
B-B-Y-Y-Y-Y-Y-Y-B-B
B-B-Y-Y-Y-Y-Y-Y-B-B
Y-Y-B-B-B-B-B-B-Y-Y
Y-Y-B-B-B-B-B-B-Y-Y
B-B-B-B-B-B-B-B-B-B
B-B-B-B-B-B-B-B-B-B
R-R-Y-Y-R-R-Y-Y-R-R
O-O-O-O-O-O-O-O-O-O
O-O-O-O-O-O-O-O-O-O
O-O-O-O-O-O-O-O-O-O
B-B-B-B-B-B-B-B-B-B