G-Y-Y-_-_-Y-Y-_-_-_
R-R-R-G-G-R-R-G-G-Y
G-G-G-G-G-R-R-R-R-R
G-G-G-G-G-R-R-R-R-R
Y-Y-Y-Y-Y-Y-Y-Y-Y-Y
Y-Y-Y-Y-Y-Y-Y-Y-Y-Y
Y-Y-Y-Y-Y-Y-Y-Y-Y-Y
Y-Y-Y-Y-Y-Y-Y-Y-Y-Y
R-R-R-R-R-G-G-G-G-G
R-R-R-R-R-G-G-G-G-G
R-R-R-R-R-G-G-G-G-G
R-R-R-R-R-G-G-G-G-G
R-R-R-R-R-G-G-G-G-G
R-R-R-R-R-G-G-G-G-G